TierType,TierName,Label,Start,Mid,End,Duration
IntervalTier,words,,0,578,1157,1157
IntervalTier,words,Dog,1157,1432,1707,550
IntervalTier,words,,1707,2318,2930,1223
IntervalTier,words,Gorilla,2930,3337,3745,815
IntervalTier,words,,3745,5111,6477,2732
IntervalTier,words,Apple,6477,6996,7515,1038
IntervalTier,words,,7515,8010,8506,991
IntervalTier,words,Elephant,8506,8897,9289,783
IntervalTier,words,,9289,10767,12245,2956
IntervalTier,words,Table,12245,12668,13092,847
IntervalTier,words,,13092,14077,15062,1970
IntervalTier,words,Eating,15062,15461,15860,798
IntervalTier,words,,15860,16403,16947,1087
IntervalTier,words,Gorilla,16947,17266,17586,639
IntervalTier,words,,17586,19561,21536,3950
IntervalTier,words,Apple,21536,21993,22450,914
IntervalTier,words,,22450,24669,26889,4439
IntervalTier,words,Elephant,26889,27360,27832,943
IntervalTier,words,,27832,29054,30277,2445
IntervalTier,words,Toss,30277,30620,30964,687
IntervalTier,words,,30964,31906,32849,1885
IntervalTier,words,Snake,32849,33237,33625,776
IntervalTier,words,,33625,35790,37956,4331
IntervalTier,words,,37956,38091,38227,271
IntervalTier,words,,38227,39673,41119,2892
IntervalTier,words,Eating,41119,41462,41806,687
IntervalTier,words,,41806,42976,44147,2341
IntervalTier,words,Girl,44147,44498,44850,703
IntervalTier,words,,44850,47538,50226,5376
IntervalTier,words,Sofa,50226,50721,51216,990
IntervalTier,words,,51216,52312,53409,2193
IntervalTier,words,Artificial,53409,54024,54639,1230
IntervalTier,words,,54639,55981,57323,2684
IntervalTier,words,Lover,57323,57762,58202,879
IntervalTier,words,,58202,59673,61144,2942
IntervalTier,words,Rat,61144,61503,61863,719
IntervalTier,words,,61863,64379,66896,5033
IntervalTier,words,Tennis,66896,67199,67503,607
IntervalTier,words,,67503,68685,69867,2364
IntervalTier,words,Soccer,69867,70322,70778,911
IntervalTier,words,,70778,72511,74245,3467
IntervalTier,words,Reading,74245,74692,75139,894
IntervalTier,words,,75139,76018,76897,1758
IntervalTier,words,Girl,76897,77192,77488,591
IntervalTier,words,,77488,78633,79779,2291
IntervalTier,words,Likes,79779,80114,80450,671
IntervalTier,words,,80450,83085,85720,5270
IntervalTier,words,Soccer,85720,86191,86662,942
IntervalTier,words,,86662,87948,89235,2573
IntervalTier,words,Rat,89235,89594,89954,719
IntervalTier,words,,89954,92259,94565,4611
IntervalTier,words,Table,94565,94996,95428,863
IntervalTier,words,,95428,98208,100989,5561
IntervalTier,words,Efficient,100989,101516,102043,1054
IntervalTier,words,,102043,103960,105878,3835
IntervalTier,words,Tennis,105878,106237,106597,719
IntervalTier,words,,106597,108258,109920,3323
IntervalTier,words,Small,109920,110407,110895,975
IntervalTier,words,,110895,112853,114811,3916
IntervalTier,words,Looks,114811,115194,115578,767
IntervalTier,words,,115578,119291,123005,7427
IntervalTier,words,Spider,123005,123484,123963,958
IntervalTier,words,,123963,125439,126916,2953
IntervalTier,words,Rate,126916,127251,127587,671
IntervalTier,words,,127587,129720,131853,4266
IntervalTier,words,Edible,131853,132316,132779,926
IntervalTier,words,,132779,133905,135032,2253
IntervalTier,words,Eating,135032,135383,135735,703
IntervalTier,words,,135735,138131,140528,4793
IntervalTier,words,Guys,140528,140871,141215,687
IntervalTier,words,,141215,144040,146866,5651
IntervalTier,words,Snowball,146866,147377,147889,1023
IntervalTier,words,,147889,150540,153191,5302
IntervalTier,words,Liquorice,153191,153741,154291,1100
IntervalTier,words,,154291,155904,157517,3226
IntervalTier,words,Earth,157517,157731,157946,429
IntervalTier,words,,157946,159195,160445,2499
IntervalTier,words,Happy,160445,160837,161229,784
IntervalTier,words,,161229,165978,170728,9499
IntervalTier,words,Yes,170728,171017,171307,579
IntervalTier,words,,171307,173861,176416,5109
IntervalTier,words,Snow,176416,176882,177349,933
IntervalTier,words,,177349,178727,180105,2756
IntervalTier,words,World,180105,180496,180888,783
IntervalTier,words,,180888,181690,182492,1604
IntervalTier,words,Dog,182492,182846,183201,709
IntervalTier,words,,183201,185319,187437,4236
IntervalTier,words,Grapes,187437,187847,188257,820
IntervalTier,words,,188257,188602,188947,690
IntervalTier,words,,188947,189227,189507,560
IntervalTier,words,,189507,193151,196796,7289
IntervalTier,words,Eating,196796,197141,197486,690
IntervalTier,words,,197486,200442,203398,5912
IntervalTier,words,Grapes,203398,203864,204330,932
IntervalTier,words,,204330,206277,208224,3894
IntervalTier,words,Elephant,208224,208662,209100,876
IntervalTier,words,,209100,213515,217930,8830
IntervalTier,words,Table,217930,218452,218975,1045
IntervalTier,words,,218975,220047,221119,2144
IntervalTier,words,Eating,221119,221464,221809,690
IntervalTier,words,,221809,225319,228830,7021
IntervalTier,words,Gorilla,228830,229202,229575,745
IntervalTier,words,,229575,231375,233175,3600
IntervalTier,words,Associate,233175,233711,234248,1073
IntervalTier,words,,234248,235133,236019,1771
IntervalTier,words,Eating,236019,236383,236747,728
IntervalTier,words,,236747,240592,244437,7690
IntervalTier,words,Girl,244437,244744,245052,615
IntervalTier,words,,245052,246618,248185,3133
IntervalTier,words,Likes,248185,248493,248801,616
IntervalTier,words,,248801,250978,253156,4355
IntervalTier,words,Starbucks,253156,253594,254032,876
IntervalTier,words,,254032,255785,257538,3506
IntervalTier,words,Snow,257538,257873,258209,671
IntervalTier,words,,258209,260777,263345,5136
IntervalTier,words,Work,263345,263662,263979,634
IntervalTier,words,,263979,264790,265602,1623
IntervalTier,words,Kangaroo,265602,266077,266553,951
IntervalTier,words,,266553,267989,269425,2872
IntervalTier,words,Oranges,269425,269826,270227,802
IntervalTier,words,,270227,271859,273491,3264
IntervalTier,words,Sun,273491,273873,274255,764
IntervalTier,words,,274255,277526,280797,6542
IntervalTier,words,Never,280797,281179,281562,765
IntervalTier,words,,281562,283562,285563,4001
IntervalTier,words,Rat,285563,285852,286141,578
IntervalTier,words,,286141,287726,289312,3171
IntervalTier,words,Tick,289312,289545,289778,466
IntervalTier,words,,289778,292725,295672,5894
IntervalTier,words,Kangaroo,295672,296091,296511,839
IntervalTier,words,,296511,299185,301860,5349
IntervalTier,words,Octopus,301860,302354,302849,989
IntervalTier,words,,302849,303865,304881,2032
IntervalTier,words,Spider,304881,305468,306056,1175
IntervalTier,words,,306056,308387,310719,4663
IntervalTier,words,Red,310719,311026,311334,615
IntervalTier,words,,311334,313170,315007,3673
IntervalTier,words,Diamond,315007,315455,315903,896
IntervalTier,words,,315903,317384,318866,2963
IntervalTier,words,Dog,318866,319220,319574,708
IntervalTier,words,,319574,320702,321831,2257
IntervalTier,words,Great,321831,322166,322502,671
IntervalTier,words,,322502,324181,325860,3358
IntervalTier,words,Today,325860,326242,326624,764
IntervalTier,words,,326624,327472,328321,1697
IntervalTier,words,Yesterday,328321,328920,329519,1198
IntervalTier,words,,329519,331459,333399,3880
IntervalTier,words,Yes,333399,333706,334014,615
IntervalTier,words,,334014,335487,336961,2947
IntervalTier,words,Sir,336961,337408,337856,895
IntervalTier,words,,337856,341777,345698,7842
IntervalTier,words,Rat,345698,345996,346295,597
IntervalTier,words,,346295,348635,350976,4681
IntervalTier,words,Table,350976,351349,351722,746
IntervalTier,words,,351722,353335,354948,3226
IntervalTier,words,Eating,354948,355359,355771,823
IntervalTier,words,,355771,358512,361253,5482
IntervalTier,words,Gorilla,361253,361598,361943,690
IntervalTier,words,,361943,363508,365074,3131
IntervalTier,words,Alphabet,365074,365540,366006,932
IntervalTier,words,,366006,368309,370613,4607
IntervalTier,words,Tomorrow,370613,371125,371638,1025
IntervalTier,words,,371638,372647,373657,2019
IntervalTier,words,We,373657,374030,374403,746
IntervalTier,words,,374403,375951,377499,3096
IntervalTier,words,Earth,377499,377741,377984,485
IntervalTier,words,,377984,379019,380054,2070
IntervalTier,words,Horses,380054,380473,380893,839
IntervalTier,words,,380893,384150,387407,6514
IntervalTier,words,Snow,387407,387836,388265,858
IntervalTier,words,,388265,390866,393468,5203
IntervalTier,words,World,393468,393841,394214,746
IntervalTier,words,,394214,396811,399409,5195
IntervalTier,words,Dangerous,399409,399866,400323,914
IntervalTier,words,,400323,403624,406925,6602
IntervalTier,words,Spider,406925,407418,407912,987
IntervalTier,words,,407912,410252,412593,4681
IntervalTier,words,Really,412593,413078,413563,970
IntervalTier,words,,413563,414328,415094,1531
IntervalTier,words,Yesterday,415094,415718,416343,1249
IntervalTier,words,,416343,417751,419159,2816
IntervalTier,words,Yes,419159,419429,419700,541
IntervalTier,words,,419700,420727,421754,2054
IntervalTier,words,So,421754,422239,422724,970
IntervalTier,words,,422724,425404,428084,5360
IntervalTier,words,Obvious,428084,428569,429054,970
IntervalTier,words,,429054,431854,434655,5601
IntervalTier,words,Spectrum,434655,435251,435848,1193
IntervalTier,words,,435848,437806,439765,3917
IntervalTier,words,Men,439765,440091,440417,652
IntervalTier,words,,440417,443201,445986,5569
IntervalTier,words,Never,445986,446555,447124,1138
IntervalTier,words,,447124,448233,449343,2219
IntervalTier,words,Rat,449343,449744,450145,802
IntervalTier,words,,450145,451306,452468,2323
IntervalTier,words,Table,452468,452841,453214,746
IntervalTier,words,,453214,454752,456291,3077
IntervalTier,words,Enjoyable,456291,456916,457541,1250
IntervalTier,words,,457541,460237,462933,5392
IntervalTier,words,Everything,462933,463641,464350,1417
IntervalTier,words,,464350,466616,468883,4533
IntervalTier,words,Getting,468883,469396,469909,1026
IntervalTier,words,,469909,472510,475112,5203
IntervalTier,words,Great,475112,475373,475634,522
IntervalTier,words,,475634,477868,480102,4468
IntervalTier,words,To,480102,480419,480737,635
IntervalTier,words,,480737,483058,485380,4643
IntervalTier,words,Oranges,485380,485846,486312,932
IntervalTier,words,,486312,487554,488797,2485
IntervalTier,words,Snake,488797,489058,489319,522
IntervalTier,words,,489319,491659,494000,4681
IntervalTier,words,effort,494000,494361,494723,723
IntervalTier,words,,494723,496221,497720,2997
IntervalTier,words,today,497720,498065,498410,690
IntervalTier,words,,498410,500807,503205,4795
IntervalTier,words,yoyo,503205,503708,504212,1007
IntervalTier,words,,504212,507671,511130,6918
IntervalTier,words,Orange,511130,511512,511895,765
IntervalTier,words,,511895,514328,516762,4867
IntervalTier,words,Sunday,516762,517247,517733,971
IntervalTier,words,,517733,518833,519933,2200
IntervalTier,words,yoyo,519933,520380,520828,895
IntervalTier,words,,520828,522838,524848,4020
IntervalTier,words,office,524848,525202,525557,709
IntervalTier,words,,525557,527664,529771,4214
IntervalTier,words,Everything,529771,530242,530713,942
IntervalTier,words,,530713,532158,533603,2890
IntervalTier,words,Good,533603,533836,534070,467
IntervalTier,words,,534070,535790,537510,3440
IntervalTier,words,Diet,537510,537836,538162,652
IntervalTier,words,,538162,539728,541295,3133
IntervalTier,words,Tomorrow,541295,541789,542284,989
IntervalTier,words,,542284,543552,544820,2536
IntervalTier,words,Wednesday,544820,545323,545827,1007
IntervalTier,words,,545827,547018,548210,2383
IntervalTier,words,Yesterday,548210,548751,549292,1082
IntervalTier,words,,549292,551175,553059,3767
IntervalTier,words,yoyo,553059,553572,554085,1026
IntervalTier,words,,554085,556608,559131,5046
IntervalTier,words,okay,559131,559569,560008,877
IntervalTier,words,,560008,560567,561127,1119
IntervalTier,words,yoyo,561127,561822,562518,1391
IntervalTier,words,,562518,563180,563842,1324
IntervalTier,words,,563842,564644,565446,1604
IntervalTier,words,,565446,567152,568859,3413
IntervalTier,words,orange,568859,569306,569754,895
IntervalTier,words,,569754,570856,571958,2204
IntervalTier,words,elephant,571958,572424,572891,933
IntervalTier,words,,572891,575657,578423,5532
IntervalTier,words,Tuesday,578423,578954,579486,1063
IntervalTier,words,,579486,581798,584111,4625
IntervalTier,words,yesterday,584111,584647,585183,1072
IntervalTier,words,,585183,585919,586656,1473
IntervalTier,words,yes,586656,586926,587197,541
IntervalTier,words,,587197,588406,589616,2419
IntervalTier,words,slow,589616,590035,590455,839
IntervalTier,words,,590455,594077,597699,7244
IntervalTier,words,obvious,597699,598212,598725,1026
IntervalTier,words,,598725,601689,604653,5928
IntervalTier,words,Sunday,604653,605334,606015,1362
IntervalTier,words,,606015,607413,608812,2797
IntervalTier,words,eating,608812,609157,609502,690
IntervalTier,words,,609502,613676,617851,8349
IntervalTier,words,,617851,617972,618094,243
IntervalTier,words,,618094,619567,621040,2946
IntervalTier,words,Great,621040,621376,621712,672
IntervalTier,words,,621712,622137,622562,850
IntervalTier,words,,622562,622693,622824,262
IntervalTier,words,,622824,625304,627784,4960
IntervalTier,words,Table,627784,628213,628642,858
IntervalTier,words,,628642,631219,633797,5155
IntervalTier,words,Eat,633797,634133,634469,672
IntervalTier,words,,634469,635392,636315,1846
IntervalTier,words,Tick,636315,636539,636763,448
IntervalTier,words,,636763,638068,639373,2610
IntervalTier,words,kid,639373,639634,639896,523
IntervalTier,words,,639896,641276,642657,2761
IntervalTier,words,dog,642657,642927,643198,541
IntervalTier,words,,643198,644138,645078,1880
IntervalTier,words,got,645078,645292,645507,429
IntervalTier,words,,645507,647362,649218,3711
IntervalTier,words,to,649218,649488,649759,541
IntervalTier,words,,649759,650766,651773,2014
IntervalTier,words,orange,651773,652081,652389,616
IntervalTier,words,,652389,654269,656149,3760
IntervalTier,words,Eat,656149,656308,656467,318
IntervalTier,words,,656467,659474,662482,6015
IntervalTier,words,To,662482,662846,663210,728
IntervalTier,words,,663210,665475,667741,4531
IntervalTier,words,Opposite,667741,668272,668804,1063
IntervalTier,words,,668804,669540,670277,1473
IntervalTier,words,Eating,670277,670613,670949,672
IntervalTier,words,,670949,672534,674119,3170
IntervalTier,words,Good,674119,674343,674567,448
IntervalTier,words,,674567,677302,680037,5470
IntervalTier,words,dog,680037,680289,680541,504
IntervalTier,words,,680541,681426,682312,1771
IntervalTier,words,great,682312,682554,682797,485
IntervalTier,words,,682797,684356,685916,3119
IntervalTier,words,taking,685916,686354,686792,876
IntervalTier,words,,686792,689997,693202,6410
IntervalTier,words,good,693202,693491,693780,578
IntervalTier,words,,693780,694536,695293,1513
IntervalTier,words,dog,695293,695573,695853,560
IntervalTier,words,,695853,698954,702056,6203
IntervalTier,words,going,702056,702438,702821,765
IntervalTier,words,,702821,703688,704555,1734
IntervalTier,words,great,704555,704779,705003,448
IntervalTier,words,,705003,707318,709633,4630
IntervalTier,words,together,709633,710108,710584,951
IntervalTier,words,,710584,713660,716736,6152
IntervalTier,words,reading,716736,717230,717724,988
IntervalTier,words,,717724,718973,720223,2499
IntervalTier,words,great,720223,720549,720876,653
IntervalTier,words,,720876,722246,723616,2740
IntervalTier,words,together,723616,724119,724623,1007
IntervalTier,words,,724623,726305,727988,3365
IntervalTier,words,running,727988,728426,728865,877
IntervalTier,words,,728865,731019,733173,4308
IntervalTier,words,good,733173,733443,733714,541
IntervalTier,words,,733714,735467,737220,3506
IntervalTier,words,dog,737220,737471,737723,503
IntervalTier,words,,737723,739344,740965,3242
IntervalTier,words,gathering,740965,741450,741935,970
IntervalTier,words,,741935,743193,744452,2517
IntervalTier,words,great,744452,744722,744993,541
IntervalTier,words,,744993,747100,749207,4214
IntervalTier,words,taking,749207,749701,750195,988
IntervalTier,words,,750195,751220,752246,2051
IntervalTier,words,good,752246,752498,752750,504
IntervalTier,words,,752750,754308,755867,3117
IntervalTier,words,dog,755867,756146,756426,559
IntervalTier,words,,756426,759214,762002,5576
IntervalTier,words,good,762002,762524,763046,1044
IntervalTier,words,,763046,764245,765445,2399
IntervalTier,words,diet,765445,765781,766117,672
IntervalTier,words,,766117,767523,768929,2812
IntervalTier,words,tomorrow,768929,769443,769958,1029
IntervalTier,words,,769958,771262,772566,2608
IntervalTier,words,when,772566,772939,773312,746
IntervalTier,words,,773312,776151,778990,5678
IntervalTier,words,never,778990,779530,780071,1081
IntervalTier,words,,780071,782684,785297,5226
IntervalTier,words,Running,785297,785744,786192,895
IntervalTier,words,,786192,787945,789698,3506
IntervalTier,words,ghost,789698,790034,790370,672
IntervalTier,words,,790370,792495,794621,4251
IntervalTier,words,spider,794621,795003,795385,764
IntervalTier,words,,795385,796550,797716,2331
IntervalTier,words,rat,797716,798024,798332,616
IntervalTier,words,,798332,800062,801793,3461
IntervalTier,words,together,801793,802296,802800,1007
IntervalTier,words,,802800,803574,804348,1548
IntervalTier,words,gathering,804348,804833,805318,970
IntervalTier,words,,805318,807140,808962,3644
IntervalTier,words,great,808962,809279,809596,634
IntervalTier,words,,809596,811610,813624,4028
IntervalTier,words,tokens,813624,814090,814557,933
IntervalTier,words,,814557,816089,817621,3064
IntervalTier,words,so,817621,818124,818628,1007
IntervalTier,words,,818628,820262,821897,3269
IntervalTier,words,office,821897,822363,822829,932
IntervalTier,words,,822829,824414,825999,3170
IntervalTier,words,either,825999,826447,826895,896
IntervalTier,words,,826895,828452,830009,3114
IntervalTier,words,reading,830009,830419,830830,821
IntervalTier,words,,830830,832533,834236,3406
IntervalTier,words,getting,834236,834674,835112,876
IntervalTier,words,,835112,837170,839229,4117
IntervalTier,words,great,839229,839499,839770,541
IntervalTier,words,,839770,840609,841448,1678
IntervalTier,words,table,841448,841812,842176,728
IntervalTier,words,,842176,842773,843370,1194
IntervalTier,words,elephant,843370,843845,844321,951
IntervalTier,words,,844321,845801,847281,2960
IntervalTier,words,tomorrow,847281,847803,848325,1044
IntervalTier,words,,848325,849504,850684,2359
IntervalTier,words,whenever,850684,851225,851766,1082
IntervalTier,words,,851766,854237,856709,4943
IntervalTier,words,rating,856709,857222,857735,1026
IntervalTier,words,,857735,860084,862434,4699
IntervalTier,words,get,862434,862816,863199,765
IntervalTier,words,,863199,865036,866873,3674
IntervalTier,words,to,866873,867283,867694,821
IntervalTier,words,,867694,870413,873132,5438
IntervalTier,words,on,873132,873440,873748,616
IntervalTier,words,,873748,874366,874984,1236
IntervalTier,words,no,874984,875301,875618,634
IntervalTier,words,,875618,877501,879385,3767
IntervalTier,words,office,879385,879796,880207,822
IntervalTier,words,,880207,881844,883481,3274
IntervalTier,words,elephant,883481,883910,884339,858
IntervalTier,words,,884339,886624,888910,4571
IntervalTier,words,together,888910,889497,890085,1175
IntervalTier,words,,890085,892360,894635,4550
IntervalTier,words,reading,894635,895036,895437,802
IntervalTier,words,,895437,896584,897731,2294
IntervalTier,words,girl,897731,898062,898394,663
IntervalTier,words,,898394,900725,903056,4662
IntervalTier,words,likes,903056,903336,903616,560
IntervalTier,words,,903616,906449,909282,5666
IntervalTier,words,smelly,909282,909711,910140,858
IntervalTier,words,,910140,912107,914075,3935
IntervalTier,words,yes,914075,914356,914637,562
IntervalTier,words,,914637,916017,917397,2760
IntervalTier,words,smores,917397,917891,918386,989
IntervalTier,words,,918386,919094,919803,1417
IntervalTier,words,smores,919803,920194,920586,783
IntervalTier,words,,920586,923874,927163,6577
IntervalTier,words,small,927163,927610,928058,895
IntervalTier,words,,928058,928990,929923,1865
IntervalTier,words,look,929923,930203,930483,560
IntervalTier,words,,930483,934366,938250,7767
IntervalTier,words,kangaroo,938250,938772,939294,1044
IntervalTier,words,,939294,941065,942837,3543
IntervalTier,words,opinion,942837,943415,943994,1157
IntervalTier,words,,943994,946467,948941,4947
IntervalTier,words,not,948941,949332,949724,783
IntervalTier,words,,949724,951942,954160,4436
IntervalTier,words,tonight,954160,954580,955000,840
IntervalTier,words,,955000,957275,959550,4550
IntervalTier,words,together,959550,960025,960501,951
IntervalTier,words,,960501,963230,965959,5458
IntervalTier,words,reading,965959,966481,967004,1045
IntervalTier,words,,967004,968794,970585,3581
IntervalTier,words,girls,970585,970958,971331,746
IntervalTier,words,,971331,974619,977907,6576
IntervalTier,words,smores,977907,978336,978765,858
IntervalTier,words,,978765,980956,983147,4382
IntervalTier,words,snacks,983147,983706,984266,1119
IntervalTier,words,,984266,985642,987019,2753
IntervalTier,words,sunday,987019,987457,987895,876
IntervalTier,words,,987895,989862,991830,3935
IntervalTier,words,smell,991830,992315,992800,970
IntervalTier,words,,992800,994703,996606,3806
IntervalTier,words,lasagna,996606,997184,997762,1156
IntervalTier,words,,997762,999725,1001689,3927
IntervalTier,words,apple,1001689,1002127,1002565,876
IntervalTier,words,,1002565,1004689,1006813,4248
IntervalTier,words,enjoy,1006813,1007465,1008118,1305
IntervalTier,words,,1008118,1009572,1011027,2909
IntervalTier,words,eating,1011027,1011353,1011680,653
IntervalTier,words,,1011680,1013210,1014740,3060
IntervalTier,words,grapes,1014740,1015131,1015523,783
IntervalTier,words,,1015523,1016903,1018283,2760
IntervalTier,words,snacks,1018283,1018749,1019216,933
IntervalTier,words,,1019216,1021634,1024052,4836
IntervalTier,words,smores,1024052,1024518,1024984,932
IntervalTier,words,,1024984,1026336,1027688,2704
IntervalTier,words,soda,1027688,1028238,1028789,1101
IntervalTier,words,,1028789,1032224,1035659,6870
IntervalTier,words,apple,1035659,1036069,1036479,820
IntervalTier,words,,1036479,1037933,1039388,2909
IntervalTier,words,elephant,1039388,1039929,1040470,1082
IntervalTier,words,,1040470,1042938,1045407,4937
IntervalTier,words,takes,1045407,1045668,1045929,522
IntervalTier,words,,1045929,1048204,1050480,4551
IntervalTier,words,elephant,1050480,1050880,1051281,801
IntervalTier,words,,1051281,1053234,1055188,3907
IntervalTier,words,tonight,1055188,1055608,1056028,840
IntervalTier,words,,1056028,1057088,1058149,2121
IntervalTier,words,tomorrow,1058149,1058680,1059212,1063
IntervalTier,words,,1059212,1061550,1063888,4676
IntervalTier,words,whenever,1063888,1064419,1064951,1063
IntervalTier,words,,1064951,1067523,1070095,5144
IntervalTier,words,reading,1070095,1070654,1071214,1119
IntervalTier,words,,1071214,1074039,1076864,5650
IntervalTier,words,going,1076864,1077311,1077759,895
IntervalTier,words,,1077759,1078682,1079605,1846
IntervalTier,words,getting,1079605,1080062,1080519,914
IntervalTier,words,,1080519,1082823,1085128,4609
IntervalTier,words,grapes,1085128,1085463,1085799,671
IntervalTier,words,,1085799,1088438,1091077,5278
IntervalTier,words,soda,1091077,1091496,1091916,839
IntervalTier,words,,1091916,1093426,1094936,3020
IntervalTier,words,affordable,1094936,1095486,1096036,1100
IntervalTier,words,,1096036,1097537,1099039,3003
IntervalTier,words,efficient,1099039,1099579,1100120,1081
IntervalTier,words,,1100120,1101955,1103790,3670
IntervalTier,words,tomorrow,1103790,1104303,1104816,1026
IntervalTier,words,,1104816,1107483,1110150,5334
IntervalTier,words,World,1110150,1110569,1110989,839
IntervalTier,words,,1110989,1113225,1115462,4473
IntervalTier,words,diet,1115462,1115826,1116190,728
IntervalTier,words,,1116190,1117650,1119110,2920
IntervalTier,words,time,1119110,1119474,1119838,728
IntervalTier,words,,1119838,1121246,1122654,2816
IntervalTier,words,everywhere,1122654,1123176,1123698,1044
IntervalTier,words,,1123698,1126411,1129125,5427
IntervalTier,words,eating,1129125,1129535,1129945,820
IntervalTier,words,,1129945,1131791,1133638,3693
IntervalTier,words,going,1133638,1134094,1134551,913
IntervalTier,words,,1134551,1135359,1136167,1616
IntervalTier,words,great,1136167,1136428,1136689,522
IntervalTier,words,,1136689,1138246,1139803,3114
IntervalTier,words,girls,1139803,1140083,1140363,560
IntervalTier,words,,1140363,1141658,1142954,2591
IntervalTier,words,snakes,1142954,1143206,1143458,504
IntervalTier,words,,1143458,1144726,1145994,2536
IntervalTier,words,smores,1145994,1146395,1146796,802
IntervalTier,words,,1146796,1148819,1150843,4047
IntervalTier,words,snacks,1150843,1151104,1151365,522
IntervalTier,words,,1151365,1152307,1153249,1884
IntervalTier,words,so,1153249,1153715,1154181,932
IntervalTier,words,,1154181,1155362,1156543,2362
IntervalTier,words,oranges,1156543,1157028,1157513,970
IntervalTier,words,,1157513,1159163,1160814,3301
IntervalTier,words,soda,1160814,1161224,1161634,820
IntervalTier,words,,1161634,1162809,1163984,2350
IntervalTier,words,again,1163984,1164394,1164805,821
IntervalTier,words,,1164805,1166647,1168489,3684
IntervalTier,words,never,1168489,1169039,1169589,1100
IntervalTier,words,,1169589,1173527,1177466,7877
IntervalTier,words,reading,1177466,1177895,1178324,858
IntervalTier,words,,1178324,1180960,1183596,5272
IntervalTier,words,getting,1183596,1184137,1184678,1082
IntervalTier,words,,1184678,1185703,1186729,2051
IntervalTier,words,great,1186729,1187018,1187307,578
IntervalTier,words,,1187307,1188242,1189177,1870
IntervalTier,words,to,1189177,1189466,1189755,578
IntervalTier,words,,1189755,1191661,1193567,3812
IntervalTier,words,obvious,1193567,1194024,1194481,914
IntervalTier,words,,1194481,1196066,1197652,3171
IntervalTier,words,so,1197652,1198090,1198528,876
IntervalTier,words,,1198528,1200078,1201629,3101
IntervalTier,words,orange,1201629,1202141,1202654,1025
IntervalTier,words,,1202654,1204148,1205643,2989
IntervalTier,words,eat,1205643,1205922,1206202,559
IntervalTier,words,,1206202,1207740,1209279,3077
IntervalTier,words,tomorrow,1209279,1209894,1210510,1231
IntervalTier,words,,1210510,1211240,1211971,1461
IntervalTier,words,world,1211971,1212325,1212680,709
IntervalTier,words,,1212680,1213739,1214798,2118
IntervalTier,words,dessert,1214798,1215255,1215712,914
IntervalTier,words,,1215712,1216933,1218155,2443
IntervalTier,words,taking,1218155,1218583,1219012,857
IntervalTier,words,,1219012,1221387,1223763,4751
IntervalTier,words,grandma,1223763,1224304,1224845,1082
IntervalTier,words,,1224845,1226103,1227362,2517
IntervalTier,words,,1227362,1227404,1227446,84
IntervalTier,words,About,1227446,1227879,1228313,867
IntervalTier,words,,1228313,1228801,1229290,977
IntervalTier,words,time,1229290,1229551,1229812,522
IntervalTier,words,,1229812,1231052,1232292,2480
IntervalTier,words,eating,1232292,1232609,1232926,634
IntervalTier,words,,1232926,1235404,1237882,4956
IntervalTier,words,gain,1237882,1238208,1238535,653
IntervalTier,words,,1238535,1239169,1239803,1268
IntervalTier,words,no,1239803,1240111,1240419,616
IntervalTier,words,,1240419,1240907,1241396,977
IntervalTier,words,opposite,1241396,1241871,1242347,951
IntervalTier,words,,1242347,1243792,1245238,2891
IntervalTier,words,elephant,1245238,1245722,1246207,969
IntervalTier,words,,1246207,1249249,1252291,6084
IntervalTier,words,taking,1252291,1252773,1253255,964
IntervalTier,words,,1253255,1255012,1256769,3514
IntervalTier,words,good,1256769,1257054,1257339,570
IntervalTier,words,* ,1257339,1264352,1271365,14026